Day 1
scope(n): phạm vi
grip(n): sự nắm vững, sự am hiểu
turn(n): phiên, lượt, sự thay đổi
drive(n): chiều hướng/xu thế
corporate(adj): thuộc công ty, doanh nghiệp
internal(adj): nội bộ
irrigation(n): sự tưới tiêu
equivalent(adj): tương đương
lighten sth(v): làm giảm sth
cargo(n): hàng hóa
assess quality: đánh giá chất lượng
adopt(v): áp dụng
appliance(n): thiết bị
chief(adj/n): quan trọng nhất/ người đứng đầu
within: trong vòng
according to: theo như
in addition to: bên cạnh, ngoài ra, thêm vào đó
eligible for: đủ đk cho
eligible to do sth: đủ đk để lm j
initiative(n): sáng kiến
outer suburbs(n): vùng ngoại ô
delegation(n): sự ủy thác, sự giao phó
reputation(n): danh tiếng
faithful(adj): chung thủy
wealthy(adj): giàu có
compact(adj): nhỏ gọn
realistic(adj): thực tế
statewide(n): toàn tiểu bang
conservative(adj): thận trọng
conserve(v/n)): giữ gìn, bảo tồn
conservatively(adv): bảo thủ
rather than=instead of
such as: như là/ thí dụ như
parking permit: giấy phép đỗ xe
name(v): chỉ định, bổ nhiệm, nêu tên
grant(v): trợ cấp
prove(v): chứng tỏ
successor(n): người kế nhiệm
leasing(n): sự cho thuê
Day 2
athletic field: sân thể thao
lawn mower: máy cắt cỏ
be suspended from sth: to hang sth from sth else
be suspended by/on sth (from sth)
suspend sth: đình chỉ sth
potted plant: chậu hoa
courtyard: sân
gloves: găng tay
glass bottle: chai thủy tinh 
be sawing some wood: đang cưa gỗ
hammer: cái búa
wipe(v): lau
be wiping: dang lau
be stapling: đang ghim
claim(v): khẳng định/ tuyên bố
a full/wide/broad range of sth: hàng loạt cái gì đó
claim(v): khẳng định
Day 3
be climbing a ladder: trèo lên 1 cái thang
lift(v) nhấc
wooden plank(n): ván gỗ
tie(v): buộc -> be tying(v): đang buộc, cột
pole(n): cái cột
hole(n): cái hố
plug(v): cắm -> be plugging a cord into sth: cắm dây vào sth
a coffee mug(n): cốc cà phê
leave(n): lá
be raked into a pile: được cào vào 1 đống
stair(n): bậc thang
rug(n): cái thảm
roll up(v) cuộn lại
mop(v) lau
torn down(v): đập ra
a purse(n): cái ví
umbrella(n) cái ô
basket(n): cái rổ
be fishing from a pier: câu cá ở 1 bến tàu
be boarding a boat: bước lên con thuyền
backpack(n): cái balo
gift certificate(n): thẻ quà tặng
for any amount you'd like: muốn bao nhiêu cũng được
apartment complex: chung cư
new-hire(n): nhân viên mới
orientation(n): buổi đào tạo định hướng
manual: bản hướng dẫn
city hall: tòa thị chính thành phố
a fifteen-page contract
funding: đầu tư 
Day 4
On behalf of: Thay mặt cho
brochure(n): bản sao tài liệu
insight(n): sự hiểu biết/ kiến thức
consult(v): tham khảo